11111111111111111111111111111111
10000000000000000000000000000001
10000000000000000011111111110001
10000000000010000010000000000001
10000000000000000010001111000001
10000000000000000010000001000001
10000000000000011011111001000001
10000000000000000000000001000001
10000000000000000000001111000001
10000000000000000000000000000001
10111111111111000000000011110001
10000000000000000000000000000001
10001111000000000000001111000001
10000000000000000000001001000001
10000000000000000000000000000001
10001001000000000000000000000001
10001111000000000000001111000001
10000000000000000000000000000001
10111111111111111111111111110001
10000000000000000000000000000001
10001111001110000111001111000001
10001001001001001001001001000001
10001001001001001001001001000001
10001111001110000111001111000001
10000000000000000000000000000001
10111111111111111111111111110001
10000000000000000000000000000001
10001111111111111111111111000001
10001000000000000000000001000001
10001000111111111111111001000001
10000000000000000000000000000001
11111111111111111111111111111111