11111111111111
10000000001101
10110000011101
10010000000001
11111111101101
10000000001101
11110000011111
11110000000111
11000000110101
10000000000001
10000000000001
11000001110101
11110111111101
11111111111111
