NO ./images/wall/grass.xpm
SO  ./images/wall/pikachu.xpm
EA ./images/wall/greystone.xpm
WE ./images/wall/red.xpm

F 220,100,0

C 255,30,0


111111111111111
100000000000001
100000000000001
100000000000001
100000000000001
100000000000001
100000000000001
100000000000001
111111121111111
100000000000001
100000000000001
100000000000001
100000000000001
100000N00000001
111111111111111