NO                            images/wall/red.xpm
SO images/wall/red.xpm

WE images/wall/red.xpm
EA images/wall/red.xpm

F 220,100,0

C 255,30,0


111111111
100000001
100N00001
111111111111111

asd