111111111111111111111111111111111111111111111111111111111111111111111111111111111111111
101
1W11
101
1011
101
1011
101
1011
101
1011
101
1011
101
1011
101
1011
101
1011
101
1011
101
1011
101
1011
101
1011
101
1011
1011
101
1011
101
1011
101
1011
101
1011
101
1011
101
1011
101
1011
101
1011
101
1011
101
1011
101
1011
101
1011
101
1011
101
1011
101
1011
101
1011
101
1011
101
1011
101
1011
101
1011
101
1011
101
1011
101
1011
101
1011
101
1011
101
1011
101
1011
101
1011
101
1011
101
1011
101
1011
101
1011
101
1011
101
1011
101
1011
101
1011
101
1011
101
1011
101
1011
101
1011
101
1011
101
1011
101
1011
101
1011
101
1011
101
1011
101
1011
101
1011
101
1011
101
1011
101
1011
101
1011
101
1011
101
1011
101
1011
101
1011
101
1011
101
1011
101
1011
101
1011
101
1011
101
1011
101
1011
101
1011
101
1011
101
1011
101
1011
101
1011
101
1011
101
1011
101
1011
101
1011
101
1011
101
1011
101
1011
101
1011
101
1011
101
1011
101
1011
101
1011
101
1011
101
1011
101
1011
101
1011
101
1011
101
1011
101
1011
101
1011
101
1011
101
1011
101
1011
101
1011
101
1011
101
1011
101
1011
101
1011
101
1011
101
1011
101
1011
101
1011
101
1011
101
1011
101
1011
101
1011
101
1011
101
1011
101
1011
101
1011
101
1011
101
1011
111

